11,11,11,11,11,11,11,11,11,11,11,11,11,11,11,11,11,11,11,11,11,11,11,11,11,11,11,11,11,11,11,11,11
11,00,01,01,01,01,02,14,14,14,14,14,14,14,00,01,01,01,01,01,01,01,01,01,01,01,01,01,01,01,02,14,11
11,10,11,11,11,11,58,48,11,14,11,11,11,11,10,11,11,11,11,11,14,14,14,14,14,11,11,11,11,11,12,14,11
11,10,11,11,11,11,11,10,11,11,11,14,11,11,10,11,11,11,11,11,11,11,11,11,11,11,11,11,11,11,12,14,11
11,10,11,11,11,11,11,10,11,11,11,11,11,11,10,11,11,11,11,11,11,11,11,11,11,11,11,11,11,11,12,11,11
11,10,11,11,11,11,11,10,11,11,14,11,11,11,10,11,11,11,11,11,11,11,11,11,11,11,11,11,11,18,22,11,11
11,10,11,11,11,11,11,10,11,11,11,11,14,11,10,11,11,11,11,11,11,11,11,11,11,00,01,01,01,97,11,11,11
11,10,11,11,11,11,11,10,14,11,11,14,11,38,11,11,11,11,11,11,11,11,11,11,11,10,11,11,11,11,14,11,11
11,10,11,11,11,11,11,20,21,21,21,21,21,22,11,11,11,11,11,11,11,11,11,11,11,10,14,11,11,11,11,11,11
11,10,11,11,11,11,11,11,11,11,11,11,11,11,11,11,11,11,40,41,41,41,41,42,11,10,11,11,14,11,11,11,11
11,10,11,11,11,11,11,11,11,11,11,11,11,11,11,11,11,11,52,11,11,11,11,52,11,10,11,11,11,11,14,11,11
11,10,11,11,11,11,11,11,11,11,11,11,11,11,11,11,11,11,52,11,11,11,11,52,11,20,87,11,11,11,11,11,11
11,10,11,11,11,11,11,11,11,11,11,11,11,11,11,11,11,11,52,11,11,11,11,52,11,11,96,01,01,01,02,11,11
11,10,11,11,11,11,11,11,11,11,11,11,11,11,11,11,11,11,60,61,61,78,61,62,11,11,11,11,11,11,12,11,11
11,10,11,11,11,11,11,11,11,11,11,11,11,11,11,11,11,11,11,11,11,26,11,11,11,11,11,11,11,11,12,14,11
11,10,11,11,11,11,11,40,41,41,41,41,41,42,11,11,11,70,71,72,11,46,11,11,11,11,11,11,11,11,12,11,11
11,10,11,11,11,11,40,62,11,11,11,11,11,60,42,11,11,80,81,82,11,46,11,11,11,11,11,11,11,11,12,11,11
11,10,11,11,11,11,50,11,11,11,11,11,11,11,52,11,11,90,81,92,11,26,11,11,11,11,11,11,11,11,12,11,11
11,10,11,11,11,11,50,11,11,11,11,11,11,11,52,11,11,11,11,11,11,26,11,11,11,11,11,11,11,11,12,14,11
11,10,11,11,11,11,50,11,11,11,88,11,11,11,68,35,37,35,37,37,35,17,11,11,11,11,11,11,11,11,12,14,11
11,10,11,11,11,11,50,11,11,11,11,11,11,11,52,11,11,11,11,11,11,11,11,11,11,11,11,11,11,11,12,14,11
11,10,11,11,11,11,50,11,11,11,11,11,11,11,52,11,11,11,11,70,71,71,72,11,11,11,11,11,11,18,22,14,11
11,10,11,11,11,11,60,42,11,11,11,11,11,40,62,11,11,11,70,81,81,81,82,11,11,11,11,00,01,97,14,14,11
11,10,11,11,11,11,11,60,61,61,61,61,61,62,11,11,11,70,81,81,81,81,92,11,11,11,11,20,87,14,14,14,11
11,10,11,11,11,11,11,11,11,11,11,11,11,11,11,11,11,90,81,81,81,92,11,11,11,11,11,11,96,02,14,14,11
11,10,11,11,11,11,11,11,11,11,11,11,11,11,11,11,11,11,90,91,92,11,11,11,11,11,11,11,11,12,14,14,11
11,10,11,11,11,11,11,11,11,11,11,11,11,11,11,11,11,11,11,11,11,11,11,11,11,11,11,11,11,12,14,14,11
11,10,11,11,11,11,11,11,11,11,11,11,11,11,11,11,11,11,11,11,11,11,11,11,11,11,11,11,11,12,14,14,11
11,20,28,11,11,54,11,11,11,11,11,11,11,11,11,11,54,11,11,11,11,11,11,11,11,11,11,11,11,12,14,14,11
11,11,93,01,01,02,11,11,11,11,11,11,11,11,11,11,11,11,11,11,11,11,11,11,11,11,11,54,94,22,14,14,11
11,14,14,14,14,93,01,01,01,01,01,01,01,01,01,01,01,01,01,01,01,01,01,01,01,01,01,01,95,14,14,14,11
11,14,14,14,14,14,14,14,14,14,14,14,14,14,14,14,14,14,14,14,14,14,14,14,14,14,14,14,14,14,14,14,11
11,14,14,14,14,14,14,14,14,14,14,14,14,14,14,14,14,14,14,14,14,14,14,14,14,14,14,14,14,14,14,14,11

1,1,1,1,1,1,1,1,0,0,0,0,0,1,1,1,1,1,1,1,1,1,1,1,1,1,1,1,1,1,1,1,0
1,0,0,0,0,0,0,1,0,0,0,0,0,1,0,0,0,0,0,0,0,0,0,0,0,0,0,0,0,0,0,1,0
1,0,0,0,0,0,0,1,0,0,0,0,0,1,0,0,0,0,0,0,0,0,0,0,0,0,0,0,0,0,0,1,0
1,0,0,0,0,0,0,1,0,0,0,0,0,1,0,0,0,0,0,0,0,0,0,0,0,0,0,0,0,0,0,1,0
1,0,0,0,0,0,0,1,0,0,0,0,0,1,0,0,0,0,0,0,0,0,0,0,0,0,0,0,0,0,0,1,0
1,0,0,0,0,0,0,1,0,0,0,0,0,1,0,0,0,0,0,0,0,0,0,0,0,0,0,0,0,0,0,1,0
1,0,0,0,0,0,0,1,0,0,0,0,0,1,0,0,0,0,0,0,0,0,0,0,0,1,1,1,1,1,1,1,0
1,0,0,0,0,0,0,1,0,0,0,0,0,1,0,0,0,0,0,0,0,0,0,0,0,1,0,0,0,0,0,0,0
1,0,0,0,0,0,0,1,1,1,1,1,1,1,0,0,0,0,0,0,0,0,0,0,0,1,0,0,0,0,0,0,0
1,0,0,0,0,0,0,0,0,0,0,0,0,0,0,0,0,0,1,1,1,1,1,1,0,1,0,0,0,0,0,0,0
1,0,0,0,0,0,0,0,0,0,0,0,0,0,0,0,0,0,1,0,0,0,0,1,0,1,0,0,0,0,0,0,0
1,0,0,0,0,0,0,0,0,0,0,0,0,0,0,0,0,0,1,0,0,0,0,1,0,1,1,1,1,1,1,1,0
1,0,0,0,0,0,0,0,0,0,0,0,0,0,0,0,0,0,1,0,0,0,0,1,0,0,0,0,0,0,0,1,0
1,0,0,0,0,0,0,0,0,0,0,0,0,0,0,0,0,0,1,1,1,0,1,1,0,0,0,0,0,0,0,1,0
1,0,0,0,0,0,0,0,0,0,0,0,0,0,0,0,0,0,0,0,0,0,0,0,0,0,0,0,0,0,0,1,0
1,0,0,0,0,0,0,1,1,1,1,1,1,1,0,0,0,0,0,0,0,0,0,0,0,0,0,0,0,0,0,1,0
1,0,0,0,0,0,1,1,0,0,0,0,0,1,1,0,0,0,0,0,0,0,0,0,0,0,0,0,0,0,0,1,0
1,0,0,0,0,0,1,0,0,0,0,0,0,0,1,0,0,0,0,0,0,0,0,0,0,0,0,0,0,0,0,1,0
1,0,0,0,0,0,1,0,0,0,0,0,0,0,1,0,0,0,0,0,0,0,0,0,0,0,0,0,0,0,0,1,0
1,0,0,0,0,0,1,0,0,0,0,0,0,0,0,0,0,0,0,0,0,0,0,0,0,0,0,0,0,0,0,1,0
1,0,0,0,0,0,1,0,0,0,0,0,0,0,1,0,0,0,0,0,0,0,0,0,0,0,0,0,0,0,0,1,0
1,0,0,0,0,0,1,0,0,0,0,0,0,0,1,0,0,0,0,0,0,0,0,0,0,0,0,0,0,0,0,1,0
1,0,0,0,0,0,1,1,0,0,0,0,0,1,1,0,0,0,0,0,0,0,0,0,0,0,0,1,1,1,1,0,0
1,0,0,0,0,0,0,1,1,1,1,1,1,1,0,0,0,0,0,0,0,0,0,0,0,0,0,1,1,1,1,0,0
1,0,0,0,0,0,0,0,0,0,0,0,0,0,0,0,0,0,0,0,0,0,0,0,0,0,0,0,0,0,1,0,0
1,0,0,0,0,0,0,0,0,0,0,0,0,0,0,0,0,0,0,0,0,0,0,0,0,0,0,0,0,0,1,0,0
1,0,0,0,0,0,0,0,0,0,0,0,0,0,0,0,0,0,0,0,0,0,0,0,0,0,0,0,0,0,1,0,0
1,0,0,0,0,0,0,0,0,0,0,0,0,0,0,0,0,0,0,0,0,0,0,0,0,0,0,0,0,0,1,0,0
1,0,0,0,0,0,0,0,0,0,0,0,0,0,0,0,0,0,0,0,0,0,0,0,0,0,0,0,0,0,1,0,0
0,1,1,1,1,1,0,0,0,0,0,0,0,0,0,0,0,0,0,0,0,0,0,0,0,0,0,0,0,0,1,0,0
0,0,0,0,0,1,1,1,1,1,1,1,1,1,1,1,1,1,1,1,1,1,1,1,1,1,1,1,1,1,0,0,0
0,0,0,0,0,0,0,0,0,0,0,0,0,0,0,0,0,0,0,0,0,0,0,0,0,0,0,0,0,0,0,0,0
0,0,0,0,0,0,0,0,0,0,0,0,0,0,0,0,0,0,0,0,0,0,0,0,0,0,0,0,0,0,0,0,0